<TileMap>
  <Name>Map0002</Name>
  <Dimensions>10,10</Dimensions>
  <Spawn>0,0</Spawn>
  <Texture File="Textures\tileset.png" />
  <Portals>
    <Portal ID="1" Destination="Start" DestinationID="1" Location="0,5" Motion="1,0" />
    <Portal ID="2" Destination="Start" DestinationID="2" Location="0,6" Motion="1,0" />
  </Portals>
  <Base>
      33 33 33 33 33 33 33 33 33 33 
      33 33 33 33 19 21 33 33 33 33 
      33 33 33 33 51 53 33 33 33 33 
      33 33 33 33 33 33 33 33 33 33 
      33 33 33 33 33 33 33 33 33 33 
      66 66 67 130 131 68 66 69 33 33 
      145 147 82 83 84 117 147 145 33 33 
      33 33 33 33 100 85 33 33 33 33 
      38 33 33 33 128 117 33 33 33 33 
      38 38 33 33 80 85 33 33 33 33 
  </Base>
  <Object>
      -1 -1 -1 -1 -1 -1 -1 -1 -1 -1 
      -1 -1 -1 -1 -1 -1 -1 -1 -1 -1 
      -1 -1 -1 -1 -1 -1 -1 -1 -1 -1 
      -1 -1 -1 -1 -1 -1 -1 -1 -1 -1 
      -1 -1 -1 -1 -1 -1 -1 -1 -1 -1 
      -1 -1 -1 -1 -1 -1 -1 -1 -1 -1 
      -1 -1 -1 -1 -1 -1 -1 -1 -1 -1 
      -1 -1 -1 -1 -1 -1 -1 -1 -1 -1 
      -1 -1 -1 -1 -1 -1 -1 -1 -1 -1 
      -1 -1 -1 -1 -1 -1 -1 -1 -1 -1 
  </Object>
  <Collision>
      0 0 0 0 0 0 0 0 0 0 
      0 0 0 0 5 5 0 0 0 0 
      0 0 0 0 5 5 0 0 0 0 
      0 0 0 0 0 0 0 0 0 0 
      0 0 0 0 0 0 0 0 0 0 
      2 0 0 0 0 0 0 0 0 0 
      2 0 0 0 0 0 0 0 0 0 
      0 0 0 0 0 0 0 0 0 0 
      1 0 0 0 0 0 0 0 0 0 
      1 1 0 0 2 2 0 0 0 0 
  </Collision>
  
</TileMap>