<TileMap>
  
  <Name>Start</Name>
  
  <Dimensions>10,10</Dimensions>

  <Spawn>7,1</Spawn>
  
  <Texture File="Textures\tileset.png" />

  <ChestTexture File="Textures\chest.png" />
  <ChestOpenTexture File="Textures\chestOpen.png" />

  <SwitchTexture File="Textures\switch.png" />
  
  <Portals>    
    <Portal ID="01" Destination="Map0002" DestinationID="01" Location="9,5" Motion="-1,0" />
    <Portal ID="02" Destination="Map0002" DestinationID="02" Location="9,6" Motion="-1,0" />    
  </Portals>

  <Chests>
    <Chest Name="Chest1" Location="5,1" Size="32,32" Gold="100" />
  </Chests>

  <Switches>
    <Switch Name="Switch1" Location="7,1" Size="32,32" Rotation="0" Active="False" />
  </Switches>
  
  <Base>
      33 33 33 33 33 64 67 68 69 33 
      33 33 33 33 33 144 83 84 133 33 
      33 33 33 33 33 33 33 80 97 33 
      33 33 33 19 21 33 33 116 113 33 
      33 19 20 36 37 33 33 128 101 33 
      33 35 36 36 53 33 33 96 129 65 
      33 35 37 33 33 33 33 144 82 83 
      33 51 53 33 33 33 49 49 49 49 
      33 33 33 33 33 50 22 22 22 22 
      33 33 33 33 34 22 22 22 22 22 
  </Base>
  
  <Object>
      0 0 0 0 0 0 0 0 0 0 
      0 0 0 0 0 0 0 0 0 0 
      0 0 0 0 0 0 0 0 0 0 
      0 0 0 0 0 0 0 0 0 0 
      0 0 0 0 0 0 0 0 0 0 
      0 0 0 0 0 0 0 0 0 0 
      0 0 0 0 0 0 0 0 0 0 
      0 0 0 0 0 0 0 0 0 0 
      0 0 0 0 0 0 0 0 0 0 
      0 0 0 0 0 0 0 0 0 0 
  </Object>
  
  <Collision>
      0 0 0 0 0 0 0 0 0 0 
      0 0 0 0 0 1 0 1 0 0 
      0 0 0 0 0 0 0 0 0 0 
      0 0 0 0 0 0 0 0 0 0 
      0 5 5 5 5 0 0 0 0 0 
      0 5 5 5 5 0 0 0 0 2 
      0 5 5 0 0 0 0 0 0 2 
      0 5 5 0 0 0 0 0 0 0 
      0 0 0 0 0 0 1 1 1 1 
      0 0 0 0 0 1 1 1 1 1 
  </Collision>
  
</TileMap>